8 
0 S 0 0 0 B 0 0 
0 S 0 0 0 B 0 0
0 0 0 0 0 T 0 0
0 0 0 B 0 0 0 0
0 W W 0 0 P 0 R
0 0 0 0 T S 0 0
0 S 0 0 0 S 0 0
0 S 0 0 0 S 0 0